NO ./texture/safoh.png

SO ./texture/kchrosci.png

WE ./texture/bschaafs.png

EA ./texture/safoh.png


F 235,75,179
C 73,239,245

        1111111111111111111111111
        1000000000110000000000001
        1011000001110000000000001
        1001000000000000000000001
111111111011000001110000000000001
100000000011000001110111110011111
11110111111111011100000010001
11110111111111011101010010001
11000000110101011100000010001
10000000000000001100000010001
10000000000000001101010010001
1100000111010101111101111000111
11101N111 1110101 101111010001
11111111 1111111 111111111111
