    d11111111111111111111
    10000000000000000001
    10000000000000000001
111110000000000000000001
100000111110000101010001
100000100010000000000001
100000100010000100010001
100000100010000000000001
100000101110000101010001
100000000000000000000001
100000000000000000000001
100000000000000000000001
100000000000000000000001
100000000000000000000001
100000000000000000000001
100000000000000000000001
101010101000000000000001
101010101000000000000001
101010101000000000000001
101010101000000000000001
101010101000000000000001
101010101000000000000001
101010101000000000000001
111111111111111111111111
