NO ./texture/safoh.png
SO ./texture/kchrosci.png
WE ./texture/bschaafs.png
EA ./texture/safoh.png

F 235,75,179
C 73,239,245

 1111
1S1
1111
