NO ./texture/safoh.png


111
10N1
1111